..###..#..###.###.####..###.###.#.###.########.###..#..###.#.#######..###..#....##.###.....#.#.#
##...##.#..#......#.....#..................#.#.#.#..........#.#.#..#####.#.###...#....#.....##..
.##.........#.#.........#..#...#....##.##......#...........#.#..#.#..#...#.###..#..#.......#....
###..#...#.##.#...##.##.#..##......#.#....#.#...........#.......#.......#.#....##........##.....
#..#..#......#..#..#.......##.....#.#....#.....##....#..##...##.#..##.........#.....#...##......
#...##..#...#.....#......#...#....#..##.....##..#.###....##.#..##.....###.#.....#....#.##...####
#...##..###......#....###.....#.#####.........#.##.....##.##...#..#.#.#..#...#....###........##.
#........................##.#...#.#..###...............##.........#....#.#.............#.#.....#
#.###..##.###.......#.##..#.#.####.#####..#...#.####..#.##.##.######....#...##.#..##..#..#.##.#.
...#...#...##.#.#..#.#..#.......#....#...#.#....#....#.#.#.##.###..#....#####..##..##..##.#...#.
....#.....###....#..###...........#...#..#...#..##......##......#.#####.#.##.###...#.#.#........
....#.#.#..#..#.#...#.....#...#.#....##.......#.##.##..#.#.#......#..........#..#.......##..##..
##.....#....##..#..#...#....##..##.....#.....##......#..#.#.......##..#.#...........#...##..##..
.#.##.......#.....#.#......#...##..#.#..###.....#.....#...#...#..#.#...#.....#..#.....#.#...#...
....#.#..###...###.#....#.#.#...#.......##...#####..#..#.#.#....##...###.#.........#...#.###....
##........####....##.####..........#...##.....#...#.#.#.#..#.#..#..#....#.......######..#.......
##..#.##..#..###..#..####.#...###.####.#.###.#...##.#...#.##..#..##...##..###..#..####.##.#####.
#...#.##..####.##.##...##.......#.......####..#.#.#..#..#.........#...#...#...............##....
......#.#.#...#.##.#..##........#...###.#..#...##.#.....#....##.##.#....#...#..##.......#...##..
..#...#..####..#...###....#..........#...#...........#.###......#......#....#...##.....##.#.#...
........##.#..###.##....#.....#.#.#.....#.##....##...#..#..###..#.##..#....#...##.......#......#
..#.....#.#.##.#.#.##..#.#..#..#...###....####.###.#.#..........#.###...##.##..####..#.##...#...
##.#..##.#....#.#.##.#..#.#...###.##...........#.#.#............#...#.#........#...#..#.......#.
....#...#..#.#..###...##.###.#.#....#...##...#.#.#.......#......#.......#......##...........##..
####....##.#.#..##.###...#...#.##.#..##.###..#..#.####.###.......#.#...#...#.##..###.....##..#..
#...#.###...##......#.#..###......#......###....#...#.###.###...#.#......#.##...#......#...#..##
........#....#..#...#.....#.#..#.#...#...#...#..#.##.#..#...##....#.......##..#.......#.#....#.#
#......##.....#.....##..#.........#....##.......##.#..#.##.#.##..#..#.##..##.......#..#....#....
...#.#.##.#......##.#.#.#.#.#..#..#.#...####.#.###..##..#..#.#.....#..#.#..#....#....#.#.#.#....
##...##....#.....##..####....#.###..#....#.......##....##...##.#...##..##...........#...........
.....#.....#..#.....##....#.#.##..#.#..#.##.##.......#..#..#..#.#...#.#....#.......#....#....#.#
.....#.###..##.....###..##..#..#.##.....#.#........#.#...####.#....#....##.....##.......#.......
##..#...######...##......#####...#...#.#####...#.##......#.#..#.#####.##..##..#..###..##...#....
.#..#...#.....#...#......##.#....#.##..#.###....#.....#.#...##...#..#........##.#..#.##..#..#..#
.##.#.#....#......###................#..........##..###.#.#.#.#..#.##..#.......#####.#..#.#..##.
#...#....##.#.......##.##.#.....#...#..................#.#.#...##.#....##......#.#..#.###....##.
........#....#..#...#...#####......#.#..##.#.........###.#.....#.#......#.....#.#...#.#.#.###.##
#.##.....#.#.#..#.###..#.....#..........##.#..##.#......#.......##....#.##...#.#....####.##.#...
..#........##...#..#....#...............#..#..#.#.#.##.##.##.#.#........##....#.#.#....#..#..#.#
###.#..##.....#......##.....#.#.#..#..#..#.#......##..#.#.............###.....#............#....
.###.#.#.......#.#.....##.#..#..##.#.#.#######...###.#..##.#.##..###......#...##......#.##..#.##
..##...........#..##..#.#.#.....##..#.#.#.......#..##..##.#....#...#...#.........#........#....#
#......##.#.###.##.#....##..#...#....##.####......#....#......#.#...#.....#.#.............###.#.
###.....#.#..#..#........#..#.#...#....#......###...#......#....#...##..##.#.##........##.#.#...
.#.##...#...##.#....#............##........#...##.........#....#.#......#...#..#.#.##..........#
#....#.#..##..#.#..##.#.#.......#.......#....#...#...#..##...#..#.........#.....#####...##..#...
......#.#........#...#..#..#....#....#.##.#...#..##.#...##...##........#.#...##...#....#...#..##
##..#.#....#.....###.##..#......#.#.#.....###.#...#.#..#..#..##.#.##.......#.##....###.##.......
####.#.#..#..##.####..##...#.##.#.###...##.##.#.#####.#.#.#..#.#..#.####.##....#..#.#.##..##.##.
##.##...#...#...#..#...#......#......##..#..#....#.#.##.#...#..#..#..#.....##.....#.#.....#...#.
.##.#...#...#...#....##...#..#.#....##.#......#...#.....#...#.#.#....#..#.#...###.#..........#..
...##.#.#....##..##..##....##...#.......#.......#...#..#..##.#..#...##..#.......#....#...#.#.#..
..#.....##.##...#..#....###.#####....#.#..#.........####......#.##...#.#.....#..#.......#.#.....
#...#....#.#..#.##......#......#..##...##..#.......####.....#..##...#..........#........#..#....
#..#...##.#........#...##.....###..##........#..#.##.#....#..#.....###...#..............#......#
#..........#..#.#.#.###..##.#..#......###...##..#.......#..##.......#..#........#..#..#####.....
#.#........#.#.#.##...#.#..##..###.#...###.#....#.#.#.....#.##..#.##..####.#..#......##....##.##
###...#...#.......#.#....#.......#.#....#...#.........#.#..##...##.#....#.#.##....#....#..#...#.
..#..#####..#.#....#....#.##.#...#...##.#.....#.........#.#....#..##..#.#.....####....#.#.....##
.#...#.#..#..#.....##....#...#...#.#..#.##.#.#..#..#.#.##..#....#.......#..#..#.#..#.#.#...#....
...#..#.#..##...#.#..#.####...#.#.#.....#.###.#.##.#.#..#.#.....#....#....#.##..###.#.##........
##..#.#...##....##......#.#.#..#.#....##........##..###.#.......##.......#...#.....##...........
...#......##...#.#..#......#..#.#....#..#...#.##.##..#..######...#.#.....#..#......#.....#...#..
.........#.......##.......#.##..#.....#.#.....###.#..#..##..#..#.##.#....#............###.....#.
.#.#.#..#..###.##.##.#..#....###.####.###.......#...##...#.###.#.#.#.#.#.#...#.#.#.#.##.###..#.#
#.#.....#........#..#..###.###...##..#.##....#..##..#.#.#..##..#...#....##..#...##.#....#.#.....
#......#........#...#....#.#...#....#...#.##...##....#..#..#.##....#.......#....##.#.#.###......
#.....#......#.##.#.#######.#..##.#.#...###.#...#...#...#...##.....#.#..........#..#..#.##.....#
##.....#.#.#..###..#............#.#.#..###.#.....#.##..#..#..#.#........#...##..###..#..#.......
....#.#....##.......##..##.......#.##..#.#...#.#..#....##.#.#..##.....###......##...#...#.......
....#.#....#.....#...#.#..#...##.#....#.##.....###.....#........#.......#...#.#.#.##....#...#.#.
#..#....#....#.....#...###...##.#.#...#.#.......##...##........#.#..#..#..#....##..#........##.#
..###..##..###.#.#.##.##...#..##..##.#......####.#.##...##.#.##.#.##..#.###.#.#.###..####.#..#.#
.###...##..#...#...##.#..##.......#.#.......#....#..#.#.#.#..####..##.###...#..#..##....#.#.#...
#........##..#...#.....#........#..#..#....#....#....#........##..#............#.........#......
#...#.........#.##..#...#......#..#.###.#.###...#....#.......##..###........#.....#.#..........#
#.##.#.....#..###....#.#......#.#....##....#...#.#....#####..#..##.#.#...##.......#.....#......#
#.##...#.#...###.......##....##...#.#....##..#..#####...#..####.#..#....#......#..##....##..#.#.
#....#...........##...#...#.#.#..#...#..#...###.#....#...#...####..##..##...#....#..##.##..#....
##......#...#..###....#...#..#..#.#.#...#..#.##.#...###.#...####..#.#...#.................##.#..
#....##.#..#######..#...#.#...##.........##..##...#....#.#.##.##.##..#..#.#.####.####.#.#####...
##...#..#...#..............#........##..#.......#..#....#....#...........#..#...#....##.#.......
#.###.#.#..#....#..#.#.....#....##..#.#.....#...##.#.#....##.##.#.#...##.#..#...#.#........##...
...........#.....#.#....#...#...#.##......#.##..##...####....##.##..............#.........#.##..
#......#.#......#.##..##.#..#.#...#.##....##....#......#....#..#.#...###....#...#....#..#.#.....
#....#....#.....#..####.......#.##.#..#.#........##..#......#.##..#........#.#..#....#.....#.#.#
#......#.#.#....#..#.####.#.#..##.##....#.....#....#.#..###.#...........#.....##.#..#......#...#
##.#..#.#.....#.#....###...#....####....#....#..#...##.....#....#.#...#.#..##...#....#....#.....
##..#####..##...#..#######....#.#....#....##.#.###..#######.#...#.###.#.#.....#....###.#..##..#.
#.#..#.#..####...#......#.##.#..#....#.#.#..##...#...#........##......##........##.###.....##...
...#...........###..#...#...#.###..#....#.....#.#.##....#...........................###....##.#.
#..###..#.......#..#..#.#...##..#.#......##..#.....#........#..#......####..##..##..##..##...#.#
#...##..#...#...#.##...##..##..###.#....#....#.##.....#.#...##.##......#.##.##..##...##.........
#..#.#..#..#....#..##..#...#.....#.#........#..###.#.##....##..##...#.#.##..#...###.............
....#...#..#....#.#.....##......#.....#...#...........#......#......#.#.#....#.#....#..#......##
#.###...#...#.#.##....#....#..#......#...##.....#........#......#.####.....#..#.#....#.#.#.###..